1111111111111111111111111111111111111111
1833133482882233111114332223338284811111
1338143323343323133431833334332333133831
1423133323288348143332133882833831383331
1233183338333281822213313323334331833831
1283311384833321334623234833883313383331
1338388133233343143328333242833318843231
1884838384338332322883822381111113433221
1333233332383311113332383328111123334331
1833338333238238833243333433811433328881
1333338832338218214333833483312333423331
1483881333833212313383332333112433338221
1333331113111118483332333883323488833321
1318343318322283342232883334233343338221
1831333233233343233334348881111133433331
1343122332333433388333223381111143332281
1833813332223383333338333318888813343331
1333322333343338838333111183433312323321
1833333343332333323331343314333334433331
1333833333833334833333343333888832333231
1433333332333333335333333333333333323331
1333833338343311113332383328111183334331
1332143323383323133431233334332333133431
1833813332223383333338333318888813343331
1333233332343311113332323324111183334331
1332143323343323133431233334332333133431
1333331113111118483332333243323448833381
1888888833333333333333388833333333333881
1113332481111111111111442333111183388881
1111111111111111111111111111111111111111
