1111111111111111111111111111111111111111
1828388282382223382182824228882822823331
1238488833438858882122233333822888122321
1434332388322833821182238223322828143231
1333883228833328212333832332283211133821
1888823228888222183333238828828122833321
1883331111228821383833383338181243233221
1223328888333888333232888881131822838821
1228823883113232488228888111131332838821
1383333381113888388248288383181882838381
1834388388118343338383838882823222333331
1888838383383333383838383383223888388811
1883338322283883383338338838383844383311
1438338232883888882888683833411133338111
1832388388111888883328883838381888832881
1388333381888833883232383333881833882831
1432823318888833883332382282381883828281
1313311128383382883833283883818338233321
1223383333234228843888282834138333334281
1833332823233333333388333881838333328321
1338848838333341133838833388838843433281
1883338332283883383338338838383843383311
1223383333334228843888282834138343324281
1228488833338838882123333333822888122331
1883331111228821383823383338181332233221
1883331111228821383823383338181242232331
1388333381888833883322383333881833883831
1238488833448838882122233333822888132321
1328822883113222488228888111131332838821
1111111111111111111111111111111111111111
