1111111111111111111111111111111111111111
1283333234438333232224811333433882338841
1838833323223332333811383133833832888331
1233333132233323333128334331183332488331
1334382211388223313343332232313338282331
1343312888138333133383133233333313333221
1333183333381331332233134228822388133331
1831383382433133383333132483823388333331
1833338823431333383333332343338333313331
1134343323313322883311332223311133313411
1331432332232224312388333313381133328331
1428138334333231328833231133231132822331
1334313333311333348432213333133183322881
1333331332332333338333318333322333333331
1333333322322223333333113343332233223331
1838322333111113223333338322338283323341
1223331138832823311313222338288822323231
1823312213333333483313232334333333883231
1233132333133313422333113333333334283231
1433833343318132333333313234333838334331
1263333838331332384833333133588833383331
1333331332332333334333312333382333333331
1233333132233323333122334331143332848331
1383318848132333133343133233333313333221
1223331138832823311313222332882222323231
1333333322382223333333113343332833823331
1831323322433133383333138423823388333331
1833332823431333343333332383338333313331
1238833323223332333811383133833832222331
1111111111111111111111111111111111111111
