1111111111111111111111111111111111111111
1333232238383338184324111353111118833221
1332814333833333182333114333311133832231
1233111111113223312333133333331432833431
1383121333331223313888233323332333338231
1388111333333883333824111111311133333241
1333833323383813333222133388333113311311
1331111111113831332233183333331113333331
1332182831233332133328111332221833223331
1338183331338332132111111333332833831111
1438183233338322338233133433338888331421
1332132623338833333233144233333333831821
1333138833123833328333111131131111111381
1334133833123833438334332333331223823331
1332111111113883133332332332331333823881
1482332888233338133311123343331388333231
1333833333333381133311324323333338338821
1332111111333111334313324323331388333231
1321333228313342231382233333213883333331
1318333334333233333332388832133834333331
1184332332332333333344333331333344833381
1332138823338833333833144233333333831421
1334133433123833432334332333331883223331
1333433333333341133311324323333338333421
1332214333833333122333114333311143432231
1388111333333843333884111111311133333341
1188332332332333333348333331333388433321
1332138833123833322333111131131111111321
1333238232323338184324111333111118833221
1111111111111111111111111111111111111111
