1111111111111111111111111111111111111111
1422222222432322442323432223224242261111
1224222242222224444222222222222242242221
1222222222222222222244222242222222322421
1222222421111311121131122444222242222111
1222424222222212242222222242241311222221
1222244422224212242222224222242222242221
1113111311113111111131111311111311131111
1533333311113333333333333333333333333331
1333323333133323333334333323333224333331
1838333833132333388833233311113333332431
1333388332333883332333383312333323333331
1433833883883343883881888814388838883221
1388888838888338838883388333883888831111
1888888338883888822288888888888888812481
1888888888838888832382838888888888183381
1111188883388488882883338388888881888881
1888888888883338833388388888888818388881
1888488811188888838838888833888888388881
1884888224188822838883888838812118888881
1883388333188888838888388424888888228881
1888884483188888838838888344438888888881
1888882338188888838233388424888888888881
1838882333182288828883833324888888811111
1883882283188888138888848342883338838881
1842888433288811138884888444838888338881
1888888333288888828888822243388388888881
1888488333188888838888888434888833888881
1881888383188888838882888333888888888881
1111111111111111111111111111111111111111
