1111111111111111111111111111111111111111
1333233323342233333322433338323383233331
1528233383833323232383432288333333323321
1333233823823433311112322334238323334131
1833384333233323313282433233383338333331
1333111388433323213332343111111111331111
1233882333333833318328233133283133334231
1233332823338232228812343323332343333331
1132884833283323833111331343323411132321
1433381338328333338332318132333218813331
1332881338338248333438311123343311138331
1433231112333283323228313133332313813321
1223333213243332333283333331333333332331
1334223413282332332433248333333323343331
1231111332428323111132838311183432332341
1233332328332338133222333331433333332331
1332234382333323133422233231322233332231
1323332332382333133223433211133211111431
1338332334332823133233323338333323332331
1283334323338233123333323323233333323331
1333833833233333383833333333833233363311
1333233833233333333233333333833233333311
1333333333233833383243383333833233333321
1333811383233888333843333388333344333321
1333243332233338338833333333333333333231
1333233883211133333233333333333333383321
1333833333433333331843133388833233383321
1333333333833333333141333333333233383321
1333234333233333333283333333333233383321
1111111111111111111111111111111111111111
