1111111111111111111111111111111111111111
1334423888888888888245848888888888888821
1334433188288888888338338388888888848381
1813331881288888883883883438888888338281
1881118888148888888333333318188888883821
1882882888818888888888888111118828383381
1881888188884883833388888888188838388821
1881888818884838344838888888828388888831
1881818881884883333388888882838888888881
1281884888883888888888888883888888888281
1288888248323888888383888888888888288381
1248483388833838883333388338828828382881
1448838138223384888388888888838838883881
1238381113423244228888888338888888288881
1383888188333242333344488338888888388281
1888881188883233888831111138888388888381
1888818818888388888818383818888888888881
1888818813333888888148383831838888183381
1383333841888888881348323838188833338881
1888288184188888811388323838118888188881
1888388811882888881338323438133888188181
1888882888883888281113111311188188388381
1888883888288828381222888288188338181881
1888888888388838881333383332138188118881
1833888888884888281838383838188818188881
1233422288833388381388383438183881188881
1231111131111188883333383332188886188331
1233188448841888883888822284388884143331
1333333333333333331333333333333333333331
1111111111111111111111111111111111111111
