1111111111111111111111111111111111111111
1444444444444444444444444444444444444441
1222222222222222222222222222222222222221
1444444444444444444444444444444444444441
1222222222222222222222222222222222222221
1444444444444444444444444444444444444441
1222222222222222222222222222222222222221
1333333333333333333333333333333333333331
1688888888888888888888888888888888888881
1888888888888888888888888888888888888881
1888888888888888888888888888888888888881
1888888888888888888888888888888888888881
1888888888888888888888888888888888888881
1888888888888888888888888888888888888881
1888838888888888888888888888888888888881
1333338888888888888588888888888888888881
1888838888888888888888888888888888888881
1888888888888888888888888888888888888881
1333338888888888888888888888888888888881
1383838888888888888888888888888888888881
1383838888888888888888888888888888888881
1888888888888888888888888888888888888881
1383338888888888888888888888888888888881
1383838888888888888888888888888888888881
1333838888888883888333838888838333838881
1888888888888883888388883888388388838881
1888838888888883888338888383888338838881
1333338888888883888388888383888388838881
1888838888888883338333888838888333833381
1111111111111111111111111111111111111111
