1111111111111111111111111111111111111111
1422222222432322442323432223224242211111
1224222242222224444222222222222242242221
1222222222222222222244422242222222324321
1222222421111111121111122444222244222111
1222424222222212242222222242241111222221
1222244422224212242222224222242222242221
1113113333333133333333311313333331131111
1533333311113333333333333333222333233331
1333333333333333333333333333232332223331
1333322222333333333333333333333233233331
1333332332333333333333333333332323333331
1333332332323333333333333333232323333361
1333332333323338888888333332332333333111
1333333333323333222333333332222333332331
1333333333223333232333333333333333332331
1333333333333322233333333333333333332331
1333333333333333333333333333333332232321
1333333333333333333333333333333333333331
1333333333333333333333333333333333323331
1333333333133333333333333444333333333331
1888288822288388283338888333888822888881
1888838888888838833881888822888833338881
1828838888888388833881188822388333388881
1883383833883888883381888888883388888881
1888383888833388883338884888888338888881
1888833388888888883333888888888883888881
1888888444888828888888888818884888888881
1888881884888881132844888818888843388881
1111111111111111111111111111111111111111
