1111111111111111111111111111111111111111
1888832283388488483888883333388888828241
1838582248888333833244888388833888338881
1888333313813181813131818833838433388281
1883888181833118811331183388338838822381
1833888111813183818881388383383834823381
1838333181818183318881838338883883888321
1388882283888838338228838888881833828821
1842444888388888828288838828881888338381
1833188833884888111888833844118338333881
1333188833388888188838883841883888333331
1888388333388888188883333818838838888331
1188383338888111133383333133383333383331
1883833838383388888388381883888838888331
1888883888888838888138318883883824488831
1883338338383888333148888883838883428361
1838883844888888388148848883333838338311
1388888888881833388111848883888838883811
1881118888881833388188848883888388883811
1338818838818888388183838838188883338111
1838818888188883833883833838311118888811
1883111181888838838838838833388188388881
1888888188188833388838833888888183888881
1888888188333888388838883883381838382881
1838881183388388882833883383831383822281
1883333383388388882883883833888383832381
1383838883883338882838333838338833883381
1883833888228883888388338333888388812881
1883883833882228388844888838333888882231
1111111111111111111111111111111111111111
